10 10
4 4 4 4 4 4 4 4 4 4 
4 1 1 1 1 4 1 4 4 4 
4 1 4 1 1 4 1 12 4 4 
4 1 4 1 1 4 1 1 1 17 
4 1 4 64 1 1 1 1 3 4 
33 1 4 64 64 4 4 1 1 4 
4 1 1 1 1 1 1 1 1 4 
4 1 4 64 64 1 1 1 1 4 
4 1 4 1 1 1 1 1 1 4 
4 4 4 4 4 4 4 4 4 4 
